NO ./assets/textures/purple_brick_wall_trippy.xpm 
SO ./assets/textures/purple_brick_wall_trippy.xpm
WE ./assets/textures/purple_brick_wall_trippy.xpm
EA ./assets/textures/purple_brick_wall_trippy.xpm
DO ./assets/textures/metal_door_bars.xpm

F 60,100,220
C 0,200,150

11111111111111111111111111111111
10000000000000000000000000000001
10000000000000000000000000000001
10000000000000000000000000000001
10000000000000000000000000000001
10000000000000000000000000000001
10000000000000000000000000000001
10000000000000000000000000000001
10000000000000000000000000000001
10000000000000000000000000000001
10000000000000000S00000000000001
10000000000000000000000000000001
11111111111111111111111111111111
