NO ./assets/textures/purple_brick_wall_trippy.xpm 
SO ./assets/textures/purple_brick_wall_trippy.xpm
WE ./assets/textures/purple_brick_wall_trippy.xpm
EA ./assets/textures/purple_brick_wall_trippy.xpm

F 60,100,220
C 0,200,150

1111111111111111111111111
1000000000110000000000001  
101100000111000000000001
100100000000000000000000111111111
11111111101100S001110000000000001
100000000011000001110111111111111
111101111111110100000000010001
11110111111111011101010010001
11000000110101011100000000001
10000000000000000000000010001
11111111111111111111111111111
11111111111111111111111111111
100000000000000011101010010001
1100000111010101111101111000111
11110111 1110101 101111010001
11111111 1111111 111111111111
