NO ./assets/textures/arrow.xpm
SO ./assets/textures/purple_brick_wall_trippy.xpm
WE ./assets/textures/purple_brick_wall_trippy.xpm
EA ./assets/textures/purple_brick_wall_trippy.xpm

F 60,100,220
C 0,200,150

1111111
110N011
1000001
1000001
1000001
1100011
1111111