NO ./assets/textures/purple_brick_wall_trippy.xpm
SO ./assets/textures/arrow.xpm
WE ./assets/textures/purple_brick_wall_trippy.xpm
EA ./assets/textures/purple_brick_wall_trippy.xpm

F 220,100,0
C 225,30,0               

1111111111111111111111111
1000000000110000000000001  
1011000001110000000000001
100100000000000000000000111111111
111111111011000001110000000000001
100000000011000001110111111111111
111101111111110100000000010001
11110111111111011101010010001
11000000110101011100000000001
10000000000000000000000010001
100000000000000011101010010001
11000001110101011111011110N0111
11110111 1110101 101111010001
11111111 1111111 111111111111