NO ./assets/textures/purple_brick_wall_trippy.xpm 
SO ./assets/textures/purple_brick_wall_trippy.xpm
WE ./assets/textures/purple_brick_wall_trippy.xpm
EA ./assets/textures/purple_brick_wall_trippy.xpm

F 60,100,220
C 0,200,150     

1111111111111111111111111111111111111
  1000000001000000000110000000000001  
   111111100101100000111000000000001
    11111111100100000000000000000001111111111
            11111111101100N001110000000000001
            100000000011000001110111111111111
            111101111111110100000000010001
        111111110111111111011101010010001
    11110000000000000110101011100000000011
    1111000010000000000000000000000010001
    1111111111111111111111111111111111111
            11111111111111111111111111111
            100000000000000011101010010001
            1100000111010101111101111000111
            11110111 1110101 101111010001
            11111111 1111111 111111111111