NO ./path_to_the_north_texture
SO ./path_to_the_south_texture
WE ./path_to_the_west_texture
EA ./path_to_the_east_texture

F 220,100,0
C 225,30,0              

1111111111111111111111111
1000000000000000000000011
1011000001110000000000001
100100000000000000000000111111111   
111111111011000001110000000000001
     100000000011000001110111111111111                    
111111111111110100000000010001
111101111111110111010100100011
110000001101010111000000000011
100000000000000000000000100011
100000000000000011101010010001
11000001110101011111011110N0111
11110111 1110101 101111010001                  
11111111 1111111 111111111111