NO ./assets/textures/purple_brick_wall_trippy.xpm 
SO ./assets/textures/purple_brick_wall_trippy.xpm
WE ./assets/textures/purple_brick_wall_trippy.xpm
EA ./assets/textures/purple_brick_wall_trippy.xpm
DO ./assets/textures/metal_door_bars.xpm

F 60,100,220
C 0,200,150     

1111111111111111111111111111111111111111111111111111111111111111111111111111111111111111111111111111
1000000000000000000000000000000000000000000000000000000000000000000000000000000000000000000000000001
1000000000000111111100000001111111000011111100000000000000001111111000011111100000000000000000000001
1000000000000100000100000001000001000000000100000000000000001000001000000000100000000000110D00010001
1000000000000100000100000001000001000000000100000000000000001000001000000000100000000000000100010001
1000000000000100000100000001000001111111000100000000000000001000001111111000100000000000110000010001
1000000000000100000111111111000001000001000100000000000000001111111000001000100000000000100100010001
100000000000010000010000000100000100000D001000000000000000100000100000D00100000000000000000000000011
1000000000000100000100000001000001000001000100000000000000001000001000001000100000000000111110010001
1000000000000111111100001111111001111111000100000000000000001111111001111111000100000000000000000001
1000000000000000000000001000001000000000000100000000000000000000000000000000000100000000000000000001
1000000000000000000000001000001000000000000D00000000000000000000000000000000000100000000000000000001
1000000000000000000001111000001111111000000100000000000000000001111111000000000100000000000000000001
1000000000000000000001000000000000000100000100000000000000000001000001000000000100000000000000000001
1000000000000000000001000000000000000100000D00000000000000000001000001000000000100000000000000000001
1000000000000000000001000000000000000100000100000000000000000001000001000000000100000000000000000001
1000000000001111111111000000000000000100000111111111110000000001000000111111111110000000000000000001
1000000000001000000001000000000000000100000100000000010000000001000000100000000010000000000000000001
100000000000100000000D000000000000000000000010000001000000000000000000010000001000000000000000000111
1000000000001100000001000000000000000100000000000100000000000001000000100000100000000000110000010001
1000000000001000111111111100001111111100000000000100000000001111111100000100000100000000000000000001
1000000000001000100000000100001000001000000100000111111000001000001000000100000111111000000000000001
1000000000001000100000000100001000001000000100000000000000001000001000000100000000000000110D00010001
1000000000001111100000000100001111111000000111111000000000001111111000000111111000000000000100010001
1000000000000000000000000000000000000000000000000000000000000000000000000000000000000000110000010001
1000000000000111111100000001111111000011111100000000000000001111111000011111100000000000111100000001
1000000000000100000100000001000001000000000100000000000000001000001000000000100000000111000000010001
1000000000000100000100000001000001000000000D00000000000000001000001000000000100000000000000000010001
1000000000000100000100000001000001111111000100000000000000001000001111111000100000000000110100010001
1000000000000100000111111111000001000001000D00000000000000001111111000001000100000000111100000010001
100000000000010000010000000100000100000D001000000000000000100000100000D00100000000000000000000000011
1000000000000100000100000001000001000001000100000000000000001000001000001000100000000000110000000001
1000000000000111111100001111111001111111000100000000000000001111111001111111000100000000000000000001
1000000000000000000000001000001000000000000000000000000000000000000000000000000100000000000000000001
1000000000000000000000001000001000000000000000000000000000000000000000000000000100000011111111100001
1000000000000000000001111000001111111000000100000000000000000001111111000000000100000000000000000001
1000000000000000000001000000000000000100000100000000000000000001000001000000000100000000000000000001
1000000000000000000001000000000000000100000000000000000000000001000001000000000100000000000000000001
1000000000000000000001000000000000000100000100000000000000000001000001000000000100000000000000000001
1000000000001111111111000000000000000100000111111111110000000001000000111111111110000000001110000001
1000000000001000000001000000000000000100000D00000000010000000001000000100000000010000000000000000001
100000000000100000000D000000000000000000000010000001000000000000000000010000001000000000000000000111
1000000000001100000001000000000000000100000D000001000W0000000001000000100000100000000000000000010001
1000000000001000111111111100001111111100000D00000100000000001111111100000100000100000000000000000001
1000000000001000100000000100001000001000000D00000111111000001000001000000100000111111000000000000001
1000000000001000100000000100001000001000000100000000000000001000001000000100000000000000110D00010001
1000000000001111100000000100001111111000000111111000000000001111111000000111111000000000110D00010001
1111111111111111111111111111111111111111111111111111111111111111111111111111111111111111111111111111

