NO ./assets/textures/purple_brick_wall_trippy.xpm 
SO ./assets/textures/white_cartoon_bricks.xpm
WE ./assets/textures/moon.xpm
EA ./assets/textures/pattern.xpm

F 207,139,1
C 12,21,197     


1111111111111111111111111111111
  11000000000000110000000000001
   11111D1100000111000000000001
    11111111100000000000000000111111
            11110001D1100N0011100001
            1000000000110000011111111
            11110000111111D100001
    11111111111100001111110111011
    111100000000000001101010111D11
    11110000100000000000000000001
    11111111111111110011111111111
            11111111DD11111111111
            1000000000000000111111
            11000001110101011111111
            11111111 1111111 111111



DO ./assets/textures/metal_door_bars.xpm

