NO ./assets/textures/purple_brick_wall_trippy.xpm 
SO ./assets/textures/purple_brick_wall_trippy.xpm
WE ./assets/textures/purple_brick_wall_trippy.xpm
EA ./assets/textures/purple_brick_wall_trippy.xpm
DO ./assets/textures/metal_door_bars.xpm

F 60,100,220
C 0,200,150     

1111111111111111111111111111111
  10000000000000110000000000001  
   1111101100000111000000000001
    11111111100000000000000000111111
            11110001D1100N0011100001
            1000000000110000011111111
            1111000011111101000001
        1111111100001111110111011
    11110000001111111111110111D11
    11110000101        1000000001
    111111111111111111111D1111111
            1111111100111D1111111
            1000000000000000111111
            11000001110101011111111
            11111111 1111111 111111