SO ./assets/textures/purple_brick_wall_trippy.xpm
F 60,100,220
WE ./assets/textures/purple_brick_wall_trippy.xpm

EA ./assets/textures/purple_brick_wall_trippy.xpm
C 0,200,150     
NO ./assets/textures/purple_brick_wall_trippy.xpm 
DO ./assets/textures/metal_door_bars.xpm

1111111111111111111111111111111
  10000000000000110000000000001  
   11111D1100000111000000000001
    11111111100000000000000000111111
            11110001D1100N0011100001
            1000000000110000011111111
            1111000011111101000001
        1111111100001111110111011
    111100000000000001101010111011
    11110000100000000000000000001
    11111111111111110011111111111
            111111110011111111111
            1000000000000000111111
            11000001110101011111111
            11111111 1111111 111111


